Rank,Country,Gold,Silver,Bronze,Total
1,Vietnam,136,105,114,355
2,Thailand,108,96,109,313
3,Indonesia,87,80,109,276
4,Cambodia,81,74,127,282
5,Philippines,58,86,116,260
6,Singapore,51,42,64,157
7,Malaysia,34,45,96,175
8,Myanmar,21,25,68,114
9,Laos,6,22,60,88
10,Brunei,2,1,6,9
11,Timor-Leste,0,0,8,8